#########################C#########################
#.................................................#
#.................................................#
#.................................................#
#.....hhhhhh.hhhhhh...........hhhhhh..hhhhhh......#
#.....hhhhhh.hhhhhh...........hhhhhh..hhhhhh......#
#.....hh=hhh.hh=hhh...........hh=hhh..hh=hhh......#
#.................................................#
#.................................................#
#.................................................#
#.....hhhhhh.hhhhhh...........hhhhhh..hhhhhh......#
#.....hhhhhh.hhhhhh...........hhhhhh..hhhhhh......#
#.....hh=hhh.hh=hhh...........hh=hhh..hh=hhh......#
#.................................................#
#.................................................#
#.....hhhhhh.hhhhhh...........hhhhhh..hhhhhh......#
#.....hhhhhh.hhhhhh...........hhhhhh..hhhhhh......#
#.....hh=hhh.hh=hhh...........hh=hhh..hh=hhh......#
#.................................................#
###################################################
