#########################<#########################
#.................................................#
#.................................................#
#.................................................#
#....$$$$$$$.$$$$$$$........$$$$$$$..$$$$$$$......#
#....$($$$($.$($$$($........$($$$($..$($$$($......#
#....$$$=$$$.$$$=$$$........$$$=$$$..$$$=$$$......#
#.................................................#
#.................................................#
#.................................................#
#....$$$$$$$.$$$$$$$........$$$$$$$..$$$$$$$......#
#....$($$$($.$($$$($........$($$$($..$($$$($......#
#....$$$=$$$.$$$=$$$........$$$=$$$..$$$=$$$......#
#.................................................#
#.................................................#
#....$$$$$$$.$$$$$$$........$$$$$$$..$$$$$$$......#
#....$($$$($.$($$$($........$($$$($..$($$$($......#
#....$$$=$$$.$$$=$$$........$$$=$$$..$$$=$$$......#
#.................................................#
###################################################
