####################
#--#--#------------#
#--------------#---#
#######------------#
#------------------#
#####----------#####
#------------------#
#########=##########
