###################################################
#^................................................#
################################################|##
#.................................................#
##|################################################
#.................................................#
#.................................................#
#.................................................#
#.................................................#
#.................................................#
##|######################|#########################
#.................................................#
################################################|##
#b................................................#
#................................................^#
###################################################
