$$$($$$$$$($$$$($$$$
$..¤..$........b...$
$..............@...$
$$$$$$$............$
$..................$
$àààà..........àààà$
$..................$
$$$$($$$$=$$$$($$$$$
