###################################################
#.................................................#
#.................................................#
#.................................................#
#.................................................#
#.................................................#
#.................................................#
u.................................................#
#.................................................#
#.................................................#
#.................................................#
#.................................................#
#.................................................#
#.................................................#
#.................................................#
#.................................................#
#.................................................#
#.................................................#
#.................................................#
###################################################
