###################################################
#.................................................#
#.................................................#
#.................................................#
#.................................................#
#.................................................#
#.................................................#
^.................................................#
#.................................................#
#.................................................#
#.................................................#
#.................................................#
#.................................................#
#.................................................#
#.................................................#
#.................................................#
#.................................................#
#.................................................#
#.................................................#
###################################################
