#######  #######
#.....####.....#
#..^..|..|.....#
#.....####.....#
#######  ####/##
            #.#
            #.#
            #.#
            #.#
            #.#
            #.#
#############|################################################################################
#.................................................#..........................................#
#.................................................#..........................................#
#....................................é............#..........................................#
#....................................é............#..........................................#
#....................................é............#..........................................#
#.................................................#..........................................#
#............................................................................................#
#............................................................................................#
#............................................................................................#
#............................................................................................#
#..............................................................................é.............#
#............................................................................................#
#....................................é.......................................................#
#............................................................................................#
#............................................................................................#
#............................................................................................#
#............................................................................................#
#............................................................................................#
##############################################################################################
