$$$($$$$$$($$$$($$$$
$**¤**$************$
$**************@***$
$$$$$$$************$
$******************$
$àààà**********àààà$
$******************$
$$$$$$$$$=$$$$$$$$$$
