$$$($$$$$$($$$$($$$$
$..¤..$............$
$..............@...$
$$$$$$$............$
$..................$
$àààà..........àààà$
$..................$
$$$$$$$$$=$$$$$$$$$$
