#############|#####################################
#.................................................#
#.................................................#
#.................................................#
#..........e......................................#
#.................................................#
#.................................................#
#.................................................#
#.................................................#
#........................u........................#
#.................................................#
#.................................................#
#.................................................#
#.................................................#
#.................................................#
#.................................................#
#.................................................#
#.................................................#
#...............................................b.#
###################################################
