#######  #######
#....z####.....#
#.....|..|..R..#
#..J..####.....#
#######  ####/##
            #.#
            #.#
            #.#
            #.#
            #.#
            #.#
#############|################################################################################
#.................................................#....................................b.....#
#.................................................#..........................................#
#....................................é............#..........................................#
#....................................é..a.........#..........................................#
#....................................é............#..........................................#
#.................................................#.......................R..................#
#.....................d......................................................................#
#..................S.........................................................................#
#...................S........................................................................#
#....................S.......................................................................#
#..............................................................................é.............#
#............................................................................................#
#....................................é.......................................................#
#...............................................S............................................#
#............................................................................................#
#............................................................................................#
#............................................................................................#
#............................................................................................#
##############################################################################################
