###=###  #######
#*****####*****#
#*****=**=*****#
#*****####*****#
#######  ####=##
            #*#
            #*#
            #*#
            #*#
            #*#
            #*#
#############=################################################################################
#*************************************************#******************************************#
#*************************************************#******************************************#
#************************************#************#******************************************#
#************************************#************#******************************************#
#************************************#************#******************************************#
#*************************************************#******************************************#
#********************************************************************************************#
#********************************************************************************************#
#********************************************************************************************#
#********************************************************************************************#
#******************************************************************************#*************#
#********************************************************************************************#
#************************************#*******************************************************#
#********************************************************************************************#
#********************************************************************************************#
#********************************************************************************************#
#********************************************************************************************#
#********************************************************************************************#
##############################################################################################
