###################################################
#*************************************************#
#*************************************************#
#*************************************************#
#*************************************************#
#*************************************************#
#*************************************************#
=*************************************************#
#*************************************************#
#*************************************************#
#*************************************************#
#*************************************************#
#*************************************************#
#*************************************************#
#*************************************************#
#*************************************************#
#*************************************************#
#*************************************************#
#*************************************************#
###################################################
