###################################################
#=************************************************#
################################################=##
#*************************************************#
##=################################################
#*************************************************#
#*************************************************#
#*************************************************#
#*************************************************#
#*************************************************#
##=######################=#########################
#*************************************************#
################################################=##
#*************************************************#
#************************************************=#
###################################################
