##########(#########
#--#--#------#-----#
#-----#------#-----#
###=###------###=###
#-----#------#----~#
###=###------###=###
#------------------#
####(####=####(#####
