$$$$$$$$$$($$$$$$$$$
$b.¤..$......$..¤..$
$.....$......$.....$
$$$|$$$......$$$|$$$
$.....$......$....~$
$$$|$$$......$$$|$$$
$..................$
$$$$($$$$=$$$$($$$$$
