#########################=##########################
#--------------------------------------------------#
#--------------------------------------------------#
#--------------------------------------------------#
#----#######-#######--------#######--#######-------#
#----#######-#######--------#######--#######-------#
#----###=###-###=###--------###=###--###=###-------#
#--------------------------------------------------#
#--------------------------------------------------#
#--------------------------------------------------#
#----#######-#######--------#######--#######-------#
#----#######-#######--------#######--#######-------#
#----###=###-###=###--------###=###--###=###-------#
#--------------------------------------------------#
#--------------------------------------------------#
#----#######-#######--------#######--#######-------#
#----#######-#######--------#######--#######-------#
#----###=###-###=###--------###=###--###=###-------#
#--------------------------------------------------#
####################################################
