#########################=#########################
#-------------------------------------------------#
#-------------------------------------------------#
#-------------------------------------------------#
#----------------################-----------------#
#----------------################-----------------#
#----------------#######=########-----------------#
#-------------------------------------------------#
#-------------------------------------------------#
#-------------------------------------------------#
#----#######-#######--------#######--#######------#
#----#######-#######--------#######--#######------#
#----###=###-###=###--------###=###--###=###------#
#-------------------------------------------------#
#-------------------------------------------------#
#----#######-#######--------#######--#######------#
#----#######-#######--------#######--#######------#
#----###=###-###=###--------###=###--###=###------#
#-------------------------------------------------#
###################################################
