        #####=######
    #####----------#####
#####------------------#####
###----------------------###
#-----################-----#
#-----################-----#
###---#######=########---###
#####------------------#####
    #####----------#####
        ############
