#########################<##########################
#**************************************************#
#**************************************************#
#**************************************************#
#****$$$$$$$*$$$$$$$********$$$$$$$**$$$$$$$*******#
#****$($$$($*$($$$($********$($$$($**$($$$($*******#
#****$$$=$$$*$$$=$$$********$$$=$$$**$$$=$$$*******#
#**************************************************#
#**************************************************#
#**************************************************#
#****$$$$$$$*$$$$$$$********$$$$$$$**$$$$$$$*******#
#****$($$$($*$($$$($********$($$$($**$($$$($*******#
#****$$$=$$$*$$$=$$$********$$$=$$$**$$$=$$$*******#
#**************************************************#
#**************************************************#
#****$$$$$$$*$$$$$$$********$$$$$$$**$$$$$$$*******#
#****$($$$($*$($$$($********$($$$($**$($$$($*******#
#****$$$=$$$*$$$=$$$********$$$=$$$**$$$=$$$*******#
#**************************************************#
####################################################
