#########################<#########################
#*************************************************#
#*************************************************#
#*************************************************#
#****************$$$$$$$$$$$$$$$$*****************#
#****************$($$$($$$$($$$($*****************#
#****************$$$$$$$!$$$$$$$$*****************#
#*************************************************#
#*************************************************#
#*************************************************#
#****$$$$$$$*$$$$$$$********$$$$$$$**$$$$$$$******#
#****$($$$($*$($$$($********$($$$($**$($$$($******#
#****$$$=$$$*$$$=$$$********$$$=$$$**$$$=$$$******#
#*************************************************#
#*************************************************#
#****$$$$$$$*$$$$$$$********$$$$$$$**$$$$$$$******#
#****$($$$($*$($$$($********$($$$($**$($$$($******#
#****$$$=$$$*$$$=$$$********$$$=$$$**$$$=$$$******#
#*************************************************#
###################################################
