        #####<######
    #####**********#####
#####******************#####
###**********************###
#*****$$$$$$$$$$$$$$$$*****#
#*****$($$$($$$$($$$($*****#
###***$$$$$$$!$$$$$$$$***###
#####******************#####
    #####**********#####
        ############
